                             """""""""""""""""                  
                             """""""""""""""""                  
                             """""""""""""""""                  
                             """""""""""""""""                  
                             """""""""""""""""                  
                             """""""""""""""""                  
      &&&&&&&&&&&&&&&        """""""""""""""""                  
      &&&&&&&&&&&&&&&        """""""""""""""""                  
      &&&&&&&&&&&&&&&        """""""""""""""""                  
      &&&&&&&&&&&&&&&        """""""""""""""""                  
      &&&&&&&&&&&&&&&        """""""""""""""""                  
      &&&&&&&&&&&&&&&        """""""""""""""""                  
      &&&&&&&&&&&&&&&        """""""""""""""""                  
      &&&&&&&&&&&&&&&        """""""""""""""""                  
      &&&&&&&&&&&&&&&        """""""""""""""""                  
      &&&&&&&&&&&&&&&        """""""""""""""""                  
      &&&&&&&&&&&&&&&        """""""""""""""""                  
      &&&&&&&&&&&&&&&        """""""""""""""""                  
      &&&&&&&&&&&&&&&                                           
      &&&&&&&&&&&&&&&                                           
      &&&&&&&&&&&&&&&                                           
                                                                
                                                                
                                                                
                                                                
                                                                
                                                                
                                                                
                                                                
!!!!!!                                     #####################
!!!!!!!!!!!!!!!!!!!!!!!!!!!!               #####################
!!!!!!!!!!!!!!!!!!!!!!!!!!!!               #####################
!!!!!!!!!!!!!!!!!!!!!!!!!!!!!!!!!!         #####################
!!!!!!!!!!!!!!!!!!!!!!!!!!!!!!!!!!         #####################
!!!!!!!!!!!!!!!!!!!!!!!!!!!!!!!!!!         #####################
!!!!!!!!!!!!!!!!!!!!!!!!!!!!!!!!!!         #####################
!!!!!!!!!!!!!!!!!!!!!!!!!!!!!!!!!!         #####################
!!!!!!!!!!!!!!!!!!!!!!!!!!!!!!!!!!         #####################
!!!!!!!!!!!!!!!!!!!!!!!!!!!!!!!!!!         #####################
     !!!!!!!!!!!!!!!!!!!!!!!!!!!!!         #####################
     !!!!!!!!!!!!!!!!!!!!!!!!!!!!!         #####################
                                           #####################
                                           #####################
                                           #####################
                                                                
                                                                
 ##########                                                     
 ##########                                                     
 ##########                                                     
 ##########                                                     
 ##########              $$$$$$$$$$$$$$$$$$                     
 ##########              $$$$$$$$$$$$$$$$$$                     
 ##########   $$$$$$$$$$$$$$$$$$$$$$$$$$$$$$$$$$$$$$$$$$$       
 ##########   $$$$$%%%%%%$$$$$$$$$$$$$$$$$$$$$$$$$$$$$$$$       
 ##########   $$$$$%%%%%%$$$$$$$$$$$$$$$$$$$$$$$$$$$$$$$$       
 ##########   $$$$$%%%$$$$$$$$$$$$$$$$$$$$$$$$$$$$$$$$$$$       
 ##########   $$$$$$$$$$$$$$$$$$$$$$$$$$$$$$$$$$$$$$$$$$$       
 ##########   $$$$$$$$$$$$$$$$$$$$$$$$$$$$$$$$$$$$$$$$$$$       
 ##########   $$$$$$$$$$$$$$$$$$$$$$$$$$$$$$$$$$$$$$$$$$$       
 ##########   $$$$$$$$$$$$$$$$$$$$$$$$$$$$$$$$$$$$$$$$$$$       
 ##########   $$$$$$$$$$$$$$$$$$$$$$$$$$$$$$$$$$$$$$$$$$$       
                         $$$$$$$$$$$$$$$$$$                     
                                  $                             
                                                                

